1 13 31
###############################
#p                            #
# #*#*#*# #*#*#*# # # # #*#*# #
# *       *     f       *   * #
# #*#*#*# # # # # #*# # #2# # #
#         *     b   *     1 * #
# #*#*# # # # # # # # # #*#*# #
# * 1     *   x     *         #
# # #2# # #*# # # # # #*#*#*# #
# *   *       d     *       * #
# #*#*# # # # #*#*#*# #*#*#*# #
#                             #
###############################
