1 13 31
###############################
#p                            #
# #x# #*#*# #*# #*#*# #*#*#*# #
#      1                      #
# #d# #*#*# #*# #*#*# #*#*#*# #
#      1                      #
# #b# #*#*# #*# #*#*# #*#*#*# #
#                             #
# #f# #*#*# #*# #*#*# #*#*#*# #
#                             #
# #s# #*#*# #*# #*#*# #*#*#*# #
#                             #
###############################
