1 13 31
###############################
#p                            #
#d#w#x#*#*#*#*#*#*#*#*#*#*#*#*#
#          1                  #
#*#*#*#*#*#*#*#*#*#*#*#*#*#*#*#
#            1                #
#x#*#*#*#*#*#*#*#*#*#*#*#*#*#*#
#              3              #
#*#*#*#*#*#*#*#*#*#*#*#*#*#*#*#
#                3            #
#*#*#*#*#*#*#*#*#*#*#*#*#*#*#*#
#                             #
###############################
