1 13 31
###############################
#p                            #
# #x# #*#*# #*# #*#*# #*#*#*# #
#            1                #
# #b# #*#*# #*# #*#*# #*#*#*# #
#             1               #
# #f# #*#*# #*# #*#*# #*#*#*# #
#              1              #
# #s# #*#*# #*# #*#*# #*#*#*# #
#               1             #
# #d# #*#*# #*# #*#*# #*#*#*# #
#                             #
###############################

