1 13 31
###############################
#p     ** *  2 * 3 *  * * *   #
# # # #*# # #*#*# # # #*#*#*# #
#d x*     ***  *  2   *   * * #
# # # # # #*# # #*#*# # # # #*#
#b    1     x **  *  *   1    #
# # # # # # # # # #*# #*# # # #
#*  *      *  *      *      * #
# # # # #*# # # #*#*# # #*# # #
#*     **  *       *   *    * #
# #*# # # # # # #*# # # # # # #
#   3   *    *   *  *   *  *  #
###############################
