1 13 31
###############################
#p                            #
# #*#*#*# #*#*#*# # # # #*#*# #
# *       *     *       * 1 * #
# #*#*#*# # # # # #*# # #2#2# #
#         *     b   *     1 * #
# #*#*# # # # # # # # # #*#*# #
# * 1     *   x     *         #
# #2#2# # #*# # # # # #*#*#*# #
# * 1 *       *     *       * #
# #*#*# # # # #*#*#*# #*#*#*# #
#                             #
###############################
