1 13 31
###############################
#p                            #
#d#w#x#*#*#*#*#*#*#*#*#*#*#*#*#
#                             #
#*#*#*#*#*#*#*#*#*#*#*#*#*#*#*#
#                             #
#x#*#*#*#*#*#*#*#*#*#*#*#*#*#*#
#                             #
#*#*#*#*#*#*#*#*#*#*#*#*#*#*#*#
#                             #
#*#*#*#*#*#*#*#*#*#*#*#*#*#*#*#
#                             #
###############################
